   3333333333333333
   4     4        3
    4  4  4       3
3    4     4      3
3     4  4  4     3
3      4  4  4    3
3       4  4  4   3
3        4        3
3         4       3
3          4      3
3                 3
3                 3
3                 3
3                 3
3                 3
3                 3
3               1 3
3333333333333333333