    333333333333333
     4         4  3
 4        4       3
      4       4   3
  4         4     3
  4               3
         4        3
    4         2 2 3
                  3
3             1 1 3
3             2 2 3
3                 3
3             1 1 3
3             2 2 3
3                 3
3 2  2 1 2   2  2 3
3 2 12 1 2 1 2  2 3
3333333333333333333